NO ./textures/north_texture.xpm
SO ./textures/south_texture.xpm
WE ./textures/west_texture.xpm
EA ./textures/east_texture.xpm

F 100,150,200
C 50,75,100

1111111111
1000000001
1010000001
1010E00001
1010000001
1010000001
1010000001
1111111111
